W W W W W W
W 0 0 G 0 W
W 0 P 0 P W
W 0 P P P W
W 0 0 S 0 W
W W W W W W