W W W W W W
W G 0 0 0 W
W 0 P S 0 W
W 0 S 0 0 W
W 0 0 0 G W
W W W W W W