W W W W W W W W W W
W G P P 0 0 0 0 0 W
W 0 P P 0 P P P 0 W
W 0 0 0 0 P P 0 0 W
W P P P P 0 P 0 P W
W P P P P P 0 0 0 W
W P P P P P P 0 0 W
W 0 0 0 0 P 0 0 0 W
W 0 0 0 0 0 S 0 0 W
W W W W W W W W W W
